18
10
9
5
Spell CAT
CAT
------------------
--              --
--              --
--              --
--     act      --
--              --
--              --
--              --
--  &       *   --
------------------