18
10
9
5
Work together to get an A!
A
------------------
--              --
--              --
--              --
--      A       --
--              --
--              --
--              --
--  &       *   --
------------------
